# 삼립호빵체

http://spcsamlip.co.kr/sandoll-samlip-hopang/

Sandoll 삼립호빵체 라이선스 표기

Sandoll 삼립호빵체는 개인 및 기업 사용자를 포함한 모든 사용자에게 무료로 제공되며 자유롭게 수정하고 재배포하실 수 있습니다. 단, 글꼴 자체를 유료로 판매하는 것은 금지하며, Sandoll 삼립호빵체는 본 저작권 안내와 라이선스 전문을 포함해서 다른 소프트웨어와 번들하거나 재배포 또는 판매가 가능합니다. 라이선스 전문을 포함하기 어려울 경우, Sandoll 삼립호빵체의 출처 표기를 권장합니다. 예) 이 페이지는 (주)SPC삼립에서 제공한 Sandoll 삼립호빵체가 사용되어 있습니다.

Sandoll 삼립호빵체 사용범위 보기

카테고리 	사용범위 	사용가능 여부

인쇄 	브로슈어, 카탈로그, DM, 전단지, 포스터, 패키지, 캘린더 등 인쇄물 	◯

책, 만화책, 잡지, 정기간행물, 신문 등 출판물 	◯

간판, 현수막, 판넬 등 제작물 	◯

신문광고, 잡지광고, 차량광고 등 광고물 	◯

신문 제목 및 텍스트 	◯

인쇄 및 문서 공유를 위한 PDF 파일 제작 	◯

CI / BI 	회사명, 브랜드명, 상품명, 로고, 마크, 슬로건, 캐치프레이즈 	◯

웹사이트 	웹페이지, 광고배너, 메일, 웹툰, E-카달로그 	◯

웹서버용 폰트 	◯

영상 	방송 및 영상물 자막 	◯

TV-CF, 온라인 영상광고 	◯

영화(DVD / 비디오), 오프닝, 엔딩크레딧 자막 	◯

개인 UCC 및 홍보물 	◯

E-Learning 콘텐츠, 온라인 동영상강좌, 플래시 강좌 등 	◯

디바이스 	모바일, MP3, PMP, 내비게이션, 셋탑박스, 게임기 등 디바이스 내 탑재 	◯

어플리케이션 GUI디자인 등 	◯

전광판 및 안내시스템, ATM기기 등 	◯

서버 	서버 탑재 후 웹서비스 및 프로그램 내 서비스(게임 등) 	◯

E-book 	E-Book 기기 내 UI 제작, 폰트탑재 	◯

도서 및 잡지 등을 E-Book 콘텐츠(ePUB, PDF)로 변환 서비스 	◯

임베이딩 	폰트파일 임베이딩 서비스 	◯

기타 	직접 판매 목적의 이미지 제작(2차 제작결과물) 	◯

스템프, T셔츠 등 서체 디자인이 직접 활용된 상품 제작 	◯

This Font Software is licensed under the SIL Open Font License, Version 1.1.

Sandoll 삼립호빵체의 저작권은 (주)SPC삼립과 (주)산돌이 공동 소유하고 있습니다.

